2 15 30
1 1 1 1 1 1 1 1 1 1 1 1 1 1 1 1 1 1 1 1 1 1 1 1 1 1 1 1 1 1
1 2 1 0 0 2 0 0 0 0 0 0 0 0 0 0 2 2 0 0 0 0 0 0 0 2 0 0 2 1
1 0 1 1 0 1 0 0 2 0 0 0 0 0 0 0 2 0 2 0 0 0 0 0 2 0 0 0 0 1
1 0 1 1 1 0 0 0 0 0 2 0 0 1 1 1 1 1 1 1 1 1 1 2 0 0 0 1 0 1
1 0 1 0 1 1 1 1 1 1 1 1 1 1 0 0 0 2 0 0 2 0 1 1 0 0 2 0 0 1
1 0 1 2 0 0 0 0 0 0 0 1 0 0 0 0 0 0 0 0 0 0 2 1 1 0 0 0 0 1
1 2 2 0 2 0 0 0 0 0 0 1 0 0 0 0 0 0 0 2 0 0 0 0 1 1 0 1 0 1
1 1 0 2 0 0 0 0 1 0 0 1 0 2 0 0 2 0 0 0 0 0 0 0 0 1 0 0 0 1
1 0 1 0 2 2 0 0 0 0 0 1 0 0 0 0 0 0 0 0 0 2 0 2 0 1 0 2 0 1
1 0 0 0 0 2 0 0 0 0 2 2 0 0 0 0 0 0 0 0 0 0 0 0 0 2 0 0 2 1
1 0 0 1 0 2 2 0 0 0 0 1 1 0 0 0 0 0 2 1 1 1 1 1 1 2 0 0 0 1
1 0 0 1 0 0 0 0 1 0 0 0 1 1 1 1 1 1 1 1 0 0 0 0 1 1 0 1 0 1
1 0 2 0 0 0 0 0 0 1 0 0 1 0 0 0 0 0 0 0 0 0 2 0 0 0 1 0 0 1
1 0 0 0 1 0 0 1 0 0 0 0 1 2 0 0 2 0 0 0 0 0 0 0 0 0 0 0 0 1
1 1 1 1 1 1 1 1 1 1 1 1 1 1 1 1 1 1 1 1 1 1 1 1 1 1 1 1 1 1


Mô tả cấu trúc tệp cấu hình màn chơi:
1/ Dòng đầu tiên bao gồm 3 số nguyên L, R, C:
L - số thứ tự màn chơi
R - số hàng của bản đồ
C - số cột của bản đồ

2/ R dòng tiếp theo, mỗi dòng có C kí tự. Mỗi kí tự đại diện cho một đối tượng trên bản đồ:
Tiles:
0 - Grass
1 - Wall
2 - Brick

Character:
p - Bomber   (x,y) = (1,1)
1 - Balloon  (x,y) = (2,3)
2 - Oneal    (x,y) = (14,15)

Items:
f - Flame Item  (x,y) =
s - Speed Item  (x,y) =
